#Example: Large parts of Africa and south east Asia
tropical = {
	1439 1415 1166 1450  1416
}
arid = {
	108 974 975 976 978 979 981 983 1009  1011
	1016 1030 1031 1034 1036 1039 1042 1048 1049  1050
	1051 1052 1053 1054 1055 1056 1061 1062 1063  1064
	1065 1067 1068 1069 1070 1072 1073 1074 1075  1076
	1077 1078 1079 1082 1083 1084 1085 1087 1089  1090
	1091 1092 1093 1094 1095 1098 1099 1100 1101  1104
	1105 1109 1110 1111 1112 1113 1115 1116 1117  1118
	1119 1120 1147 1059 1363 1365 1364 1345 1341  1386
	1384 1392 1391 1389 1382 1380 1379 1369 1372  1373
	1370 1333 1358 1349 1351 1350 1361 1367 1199  1360
	1359 1342 1356 1385 1395 1398 1422 1448 1471  1454
	1466 1461 1456 1465 1430 1432 1434 1474 1431  1437
	1435 1160 1428 1473 1161 1421 1423 1475 1472  1163
	1484 1477 1478 1447 1158 1455 1489 1433  1429
	1486
}
arctic = {
	263 264 261 252 251 253 254 255 266  267
	268 269 265 250 374 373 372 376 377  380
	379 270 276 262  275
}
#Example: Most of Europe north of med.
mild_winter = {
	70 167 173 183 184 186 190 388 389  390
	391 392 393 398 411 414 417 418 419  420
	421 422 423 428 429 430 431 432 433  435
	436 437 438 439 440 442 444 445 447  448
	450 451 452 453 454 456 457 458 459  472
	473 474 475 476 477 480 481 485 490  495
	496 497 498 499 504 507 508 510 513  514
	516 517 518 520 521 522 524 527 529  530
	532 533 536 537 539 540 541 542 543  544
	545 551 552 560 561 565 567 568 569  570
	573 576 580 581 582 585 586 593 594  595
	596 601 602 603 605 606 607 608 609  610
	611 612 619 626 628 630 633 634 636  638
	639 641 642 643 644 647 648 649 650  651
	653 654 655 656 657 658 661 663 665  666
	667 668 669 670 671 674 675 676 677  678
	679 680 681 682 683 684 685 686 687  688
	692 693 698 703 705 706 707 709 711  713
	714 715 716 742 743 744 745 758 759  760
	761 763 764 766 767 768 769 770 771  772
	773 839 840 841 842 844 845 846 847  848
	849 850 851 853 854 859 861 862 863  864
	866 867 883 885 887 890 892 893 894  895
	896 897 898 899 900 901 903 904 905  906
	907 908 909 913 914 915 916 917 918  919
	920 921 922 923 924 929 931 932 933  934
	935 936 937 947 948 950 951 953 954  955
	957 958 959 960 963 965 966 967 969  971
	1674 1675 1676 1677 1678 1679 1680 1681 1682  1683
	1684 1685 1686 1687 1688 1689 1690 1691 1692  1693
	1694 1695 1696 1697 1698 1699 1700 1701 1702  116
	123 124 138  176
}
#Example: Inland Europe & Scandinavia
normal_winter = {
	24 25 26 27 28 29 30 31 32  33
	40 42 43 44 45 46 47 51 52  53
	54 56 65 129 222 226 236 239 240  244
	245 248 256 281  318
	320 323 324 325 326 328 329 330 331  332
	334 335 336 337 382 1 5 6 8  10
	11 12 13 14 15 16 18 20 21  22
	23 49 109 110 112 114 211 356 362  363
	365 369 370 794 796 798 799 800 801  802
	803 804 805 806 807 808 810 811 812  814
	815 819 820 823 830 831 832 833 834  1665
	1666 1669 1670 1672 48 122 297 298 299  300
	301 303 304 305 306 307 338 339 340  342
	343 345 346 348 350 351 397 400 402  403
	404 405 406 407 408 409 410 441 443  491
	492 493 494 502 503 505 506 511 512  525
	526 528 538 549 550 553 554 555 556  557
	558 559 562 563 572 587 591 615 616  617
	618 620 621 622 623 631 632 635 646  673
	689 690 691 694 695 696 697 699 700  701
	719 720 721 722 723 724 725 726 728  729
	730 731 732 735 736 737 738 739 740  746
	749 750 751 754 755 757 774 775 776  777
	778 779 780 781 782 783 784 787 788  789
	790 791 792 793 835 868 872 873 874  962
	1190 1667 1668 1671 1673 174 182 187 396  446
	449 489 515 519 534 535 547 566 577  578
	583 584 589 590 592 597 625 627 637  652
	672 712 717  718
}
#Example: Russia & Lappland
severe_winter = {
	 92
	228 229 230 231 232 233 237 238 241  242
	243 246 247 249 250 251 252 253 254  255
	257 259 260 261 262 263 264 265 266  267
	268 269 270 271 272 273 274 275 276  277
	278 279 280 282 283 284 286 287 288  289
	290 291 292 293 294 296 372 373 374  375
	376 377 378 379 380 381 383 384 385  386
	387
	34 35 36 37 57 58 59 60 61  62
	63 64 66 227 352 353 354 355 357  364
	368 371 809 813 816 818 822 825 826  827
	2 38 39 394 395 413 424 425 434  478
	479 486 488 500 501 531 574 575 613  614
	645 785 786 852 855 856 857 858 860  865
	869 870 871 875 876 926 927 928  961
}
impassable = {
	38 39 122 189 190 500 531 574  575
	587 591 613 614 645 673 785 786 835  876
	1024
	702 77 985 986 987 988 989 996 1003  1008
	1012 1015 1017 1096 1140 1146 1148 1150 1218  1222
	1221  1219
	1250 1260 1276 1275 1277 1258 1259  1267
	1335 1334  1336
	1344 1371  1374
	1338
	1409 1410  1497
	1558
	1488 1614  1615
	1782 1846 1845 1827 1646  1856
	1912
	1896 1915 1914 1918 1917  1916
	1957 1958 1960 1959 1961 1962 2011
	2022
	2034
	#temporary
	2021
	107 1004 1005 994 1002 1001 1000 997 998 891
	949 912 952 973 879 1224 1139 1149
	1147 1196 1195
	1174 1185 1223 925
	1318 1319
	1579
	1862 1861  1880
	1911  1913
}
mild_monsoon = {
}
normal_monsoon = {
}
severe_monsoon = {
}
equator_y_on_province_image = 656
