#europe
taedium = {
	1 2 5 6 8 10 11 12 13 14
	15 16 18 20 21 22 23 48 49 106
	122 189 190 297 298 299 300 301 303 304
	305 306 307 338 339 340 342 343 345 346
	348 350 351 396 397 398 400 402 403 404
	405 406 407 408 409 410 439 440 440 441
	443 448 449 489 490 491 492 493 494 495
	496 497 498 499 500 502 503 505 506 507
	508 510 511 512 513 514 515 516 517 518
	519 520 521 522 524 525 526 527 529 530
	531 532 533 534 535 536 537 538 539 540
	541 542 543 544 545 547 549 550 551 552
	553 554 555 556 557 558 559 560 561 562
	563 566 567 568 569 570 572 573 574 575
	576 577 578 580 581 582 583 584 585 586
	587 589 590 591 592 593 594 595 596 597
	601 602 603 605 606 607 608 609 610 611
	612 614 615 616 617 618 619 620 621 622
	623 625 626 627 628 630 631 632 633 634
	635 636 637 638 639 641 642 643 644 645
	646 647 651 652 653 654 655 656 657 658
	661 663 665 666 667 668 669 670 671 672
	673 674 675 676 677 678 679 680 681 682
	683 684 685 686 687 688 689 690 691 692
	693 694 695 696 697 698 699 700 701 703
	705 706 707 709 711 712 713 714 715 716
	717 718 719 720 721 722 723 724 725 726
	728 729 730 731 732 735 736 737 738 739
	740 742 743 744 745 746 749 750 751 754
	755 757 758 759 760 761 763 764 766 767
	768 769 770 771 772 773 774 775 776 777
	778 779 780 781 782 783 784 785 786 787
	788 789 790 791 792 793 1700 1699 1698 1697
	1694 1696 1692 1691 1690 1689 1688 1687 1686 1685
	1684 1683 1680 1695 1678 1702 1701 1679 1676 1675
	1681 1677 1682 1674 1667 1671 1668 1673 1670 1672
	1669 1666 1665 1693 528 1 109 110 112 114
	211 355 356 357 362 363 364 365 368 369
	370 371 794 796 798 799 800 801 802 803
	804 805 806 807 808 809 810 811 812 813
	814 815 816 818 819 820 822 823 825 826
	827 830 831 832 833 834 2 67 68 69
	70 71 72 73 74 75 76 78 79 80
	81 82 83 84 85 86 87 88 89 90
	91 94 95 98 99 100 116 117 118 119
	120 121 123 124 125 126 127 128 130 131
	132 133 134 135 136 137 138 139 140 141
	142 143 144 145 146 147 148 149 150 151
	152 153 154 155 156 157 158 159 160 161
	162 163 164 165 167 168 169 170 171 173
	174 175 176 178 179 180 181 182 183 184
	186 187 188 191 192 193 195 196 197 198
	199 200 201 203 204 205 206 207 208 209
	210 213 214 215 216 217 218 219 220 388
	389 390 391 392 393 394 395 411 413 414
	417 418 419 420 421 422 423 424 425 428
	429 430 431 432 433 434 435 436 437 438
	442 444 445 446 447 450 451 452 453 454
	456 457 458 459 460 461 462 463 464 465
	466 467 468 469 470 471 472 473 474 475
	476 477 478 479 480 481 482 484 485 486
	488 501 504 565 648 649 650 837 838 839
	840 841 842 844 845 846 847 848 849 850
	851 852 853 854 855 856 857 858 859 860
	861 862 863 864 865 866 867 868 869 870
	871 872 873 874 875 877 878 880 881 883
	885 886 887 889 890 892 893 894 895 896
	897 898 899 900 901 903 904 905 906 907
	908 909 913 914 915 916 917 918 919 920
	921 922 923 924 926 927 928 929 931 932
	933 934 935 936 937 940 941 942 943 946
	947 948 950 951 953 954 955 957 958 959
	960 961 962 963 965 966 967 969 971 876
	613 835 
}
#steppe-balkans
kakigia = {
	24 25 26 27 28 29 30 31 32 33
	34 35 36 37 40 42 43 44 45 46
	47 51 52 53 54 56 57 58 59 60
	61 62 63 64 65 66 92 222 223 224
	225 226 227 228 229 230 231 232 233 236
	237 238 239 240 241 242 243 244 245 246
	247 248 249 250 251 252 253 254 255 256
	257 259 260 261 262 263 264 265 266 267
	268 269 270 271 272 273 274 275 276 277
	278 279 280 281 282 283 284 286 287 288
	289 290 291 292 293 294 296 308 309 310
	311 313 314 315 316 317 318 319 320 321
	323 324 325 326 328 329 330 331 332 334
	336 337 352 353 354 382 383 384 374 373
	372 376 375 387 386 381 378 380 377 379
	39 38 385 335 1020 1021 1071 1026 1024 1022
	1183 1186 1185 1200 1184 1151 1174 1175 1188 1187
	1238 1237 1225 1229 1230 1286 1283 1282 1281 1280
	1278 1279 1288 1277 1298 1295 1300 1299 1301 1305
	1304 1307 1309 1308 1310 1311 1259 1303 1302 1258
	1275 1285 1287 1291 1284 1292 1296 1293 1294 1297
	1289 1226 1256 1276 1252 1255 1254 1251 1261 1274
	1272 1270 1260 1199 1267 1268 1025 1271 1273 1244
	1248 1239 1240 1245 1250 1246 1266 1023 1264 1265
	1253 1018 1290 1232 1227 1228 1236 1231 1235 1269
	1243 1706 1177 1708 1709 1705 1152 1704 1703 1178
	1713 1712 1718 1717 1716 1714 1176 1721 1720 1725
	1710 1715 1722 1180 1734 1729 1728 1726 1181 1733
	1730 1727 1182 1738 1739 1735 1736 
}
asia = {
	1198 1201 1202 1197 702 1149 973 
}
sahila = { #africa

	77 106 1005 1008 1004 107 1085 1140 1147 1148
	1083 1082 1080 1086 1141 1145 1084 1142 1143 1087
	1081 1079 1146 108 1121 1122 1076 1075 1074 974
	1073 1072 1077 1078 1091 1089 1090 1067 989 988
	981 1003 1065 1068 1061 1069 1055 983 1017 1049
	1050 1011 1063 1070 1064 1096 1059 979 1056 1054
	975 1092 1093 1094 1095 976 1105 1111 1112 1115
	1189 998 997 1000 1001 1002 994 993 1015 996
	1051 978 1042 1012 1009 1062 1028 1099 1016 1098
	1030 984 1027 1041 1039 1046 1045 1048 1031 1036
	1034 1032 1044 1043 1040 1038 1052 1053 1100 985
	977 1110 1104 1101 1109 1117 1113 1119 1116 1120
	1118 1108 1106 1107 987 1037 986 1127 1131 1129
	1130 1128 1125 1123 1102 1124 1134 1136 1132 1126
	991 1150 1133 1137 1138 990 
}
oceania = {
}
#S america
venatia = {
	949 891 925 
}
#N america
chantlia = {
	952 912 1161 1164 1163 1167 1166 1160 1170 1213
	1218 1212 1211 1209 1219 1210 1158 1173 1172 1171
	1215 1205 1208 1216 1207 1221 1214 1204 1222 1217
	1194 1192 1191 
}
island_check_provinces = {
	106 2 30 
}
# Used for RNW
new_world = {
}
