#europe
taedium = { 
	1 2 5 6 8 10 11 12 13 14
	15 16 18 20 21 22 23 48 49 122
	189 190 297 298 299 300 301 303 304 305
	306 307 338 339 340 342 343 345 346 348
	350 351 396 397 398 400 402 403 404 405
	406 407 408 409 410 439 440 440 441 443
	448 449 489 490 491 492 493 494 495 496
	497 498 499 500 502 503 505 506 507 508
	510 511 512 513 514 515 516 517 518 519
	520 521 522 524 525 526 527 529 530 531
	532 533 534 535 536 537 538 539 540 541
	542 543 544 545 547 549 550 551 552 553
	554 555 556 557 558 559 560 561 562 563
	566 567 568 569 570 572 573 574 575 576
	577 578 580 581 582 583 584 585 586 587
	589 590 591 592 593 594 595 596 597 601
	602 603 605 606 607 608 609 610 611 612
	614 615 616 617 618 619 620 621 622 623
	625 626 627 628 630 631 632 633 634 635
	636 637 638 639 641 642 643 644 645 646
	647 651 652 653 654 655 656 657 658 661
	663 665 666 667 668 669 670 671 672 673
	674 675 676 677 678 679 680 681 682 683
	684 685 686 687 688 689 690 691 692 693
	694 695 696 697 698 699 700 701 703 705
	706 707 709 711 712 713 714 715 716 717
	718 719 720 721 722 723 724 725 726 728
	729 730 731 732 735 736 737 738 739 740
	742 743 744 745 746 749 750 751 754 755
	757 758 759 760 761 763 764 766 767 768
	769 770 771 772 773 774 775 776 777 778
	779 780 781 782 783 784 785 786 787 788
	789 790 791 792 793 1700 1699 1698 1697 1694
	1696 1692 1691 1690 1689 1688 1687 1686 1685 1684
	1683 1680 1695 1678 1702 1701 1679 1676 1675 1681
	1677 1682 1674 1667 1671 1668 1673 1670 1672 1669
	1666 1665 1693 528 1 109 110 112 114 211
	355 356 357 362 363 364 365 368 369 370
	371 794 796 798 799 800 801 802 803 804
	805 806 807 808 809 810 811 812 813 814
	815 816 818 819 820 822 823 825 826 827
	830 831 832 833 834 2 67 68 69 70
	71 72 73 74 75 78 79 80 81 82
	83 84 85 86 87 88 89 90 94 95
	98 99 100 116 117 118 119 120 121 123
	124 125 126 127 128 130 131 132 133 134
	135 136 137 138 139 140 141 142 143 144
	145 146 147 148 149 150 151 152 153 154
	155 156 157 158 159 160 161 162 163 164
	165 167 168 169 170 171 173 174 175 176
	178 179 180 181 182 183 184 186 187 188
	191 192 193 195 196 197 198 199 200 201
	203 204 205 206 207 208 209 210 213 214
	215 218 219 388 389 390 391 392 393 394
	395 411 413 414 417 418 419 420 421 422
	423 424 425 428 429 430 431 432 433 434
	435 436 437 438 442 444 445 446 447 450
	451 452 453 454 456 457 458 459 460 461
	462 463 464 465 466 467 468 469 470 471
	472 473 474 475 476 477 478 479 480 481
	482 484 485 486 488 501 504 565 648 649
	650 837 838 839 840 841 842 844 845 846
	847 848 849 850 851 852 853 854 855 856
	857 858 859 860 861 862 863 864 865 866
	867 868 869 870 871 872 873 874 875 877
	878 880 881 883 885 886 887 889 890 892
	893 894 895 896 897 898 899 900 901 903
	904 905 906 907 908 909 913 914 915 916
	917 918 919 920 921 922 923 924 926 927
	928 929 931 932 933 934 935 936 937 940
	941 942 943 946 947 948 950 951 953 954
	955 957 958 959 960 961 962 963 965 966
	967 969 971 876 613 835 1190 101 102 103
	104 105 76 217 220 216 2487 91 
}
#steppe-balkans
kakigia = { 
	24 25 26 27 28 29 30 31 32 33
	34 35 36 37 40 42 43 44 45 46
	47 51 52 53 54 56 57 58 59 60
	61 62 63 64 65 66 92 222 223 224
	225 226 227 228 229 230 231 232 233 236
	237 238 239 240 241 242 243 244 245 246
	247 248 249 250 251 252 253 254 255 256
	257 259 260 261 262 263 264 265 266 267
	268 269 270 271 272 273 274 275 276 277
	278 279 280 281 282 283 284 286 287 288
	289 290 291 292 293 294 296 308 309 310
	311 313 314 315 316 317 318 319 320 321
	323 324 325 326 328 329 330 331 332 334
	336 337 352 353 354 382 383 384 374 373
	372 376 375 387 386 381 378 380 377 379
	39 38 385 335 1020 1021 1071 1026 1022 1186
	1174 1188 1238 1237 1225 1229 1230 1286 1283 1282
	1281 1280 1278 1279 1288 1277 1298 1295 1300 1299
	1301 1305 1304 1307 1309 1308 1310 1311 1259 1303
	1302 1258 1275 1285 1287 1291 1284 1292 1296 1293
	1294 1297 1289 1226 1256 1276 1252 1255 1254 1251
	1261 1274 1272 1270 1260 1267 1268 1025 1271 1273
	1244 1248 1239 1240 1245 1250 1246 1266 1023 1264
	1265 1253 1018 1290 1232 1227 1228 1236 1231 1235
	1269 1243 1706 1177 1708 1709 1705 1152 1704 1703
	1178 1713 1712 1716 1714 1176 1721 1720 1725 1710
	1715 1722 1180 1734 1729 1728 1726 1181 1733 1730
	1727 1182 1738 1739 1735 1736 1183 1757 1749 1750
	1753 1751 1184 1745 1740 1746 1744 1741 1748 1151
	1762 1761 1760 1759 1758 1379 1378 1398 1368 1377
	1376 1370 1369 1333 1372 1373 1384 1394 1392 1386
	1200 1389 1387 1385 1391 1383 1390 1375 1395 1382
	1381 1380 1366 1199 1361 1362 1367 1363 1365 1364
	1347 1346 1353 1357 1342 1359 1360 1358 1355 1356
	1351 1349 1350 1352 1354 1341 1345 1337 1340 1339
	1338 1335 1336 1344 1374 1371 1334 1400 1401 1402
	1403 1404 1185 2689 2690 2693 2691 2694 2696 2695
	2699 2698 2700 2033 2708 2701 2705 2706 2712 2710
	2709 2711 2715 2714 2721 2723 2722 2719 2718 2713
	1187 2736 2735 2734 2730 2729 2728 2725 2727 2724
	2032 2100 2091 2092 2094 2093 2095 2097 2103 2104
	2102 1175 2034 2105 
}
pemenia = {  #asia

	1321 1320 1198 1201 1202 1312 1314 1315 1316 1317
	1969 1974 1975 1976 1977 1978 1979 1986 1988 1989
	1990 1991 1992 1993 1994 1995 1996 1997 1998 1999
	2000 2001 2002 2003 2004 2005 2007 2012 2025 2026
	2030 1322 1323 1955 1956 2008 2009 2010 2013 2015
	2016 2019 2020 2023 2031 1962 1957 2027 1959 2028
	2024 1961 2006 1960 1972 1970 1968 1964 1966 1965
	1963 1967 1980 1983 1973 1399 1405 1408 1407 1406
	1985 1984 1981 1982 1197 1958 2011 2022 2157 2154
	2145 1319 2160 2146 2144 2161 1318 2159 2150 2062
	2151 2155 2149 2148 2147 2158 2152 2141 2143 2142
	2139 2136 2138 2037 2135 2021 2018 2134 2137 2047
	2048 2140 2122 2121 2041 2120 2050 2126 2045 2127
	2039 2124 2098 2101 2053 2051 2125 2112 2090 2054
	2111 2113 2119 2040 2056 2131 2057 2132 2086 2075
	1755 2069 2074 2088 2115 2107 2052 2116 2108 2109
	2110 2043 2133 2216 2060 2218 2219 1806 2221 1805
	2061 2226 2225 1781 2224 2217 2211 2231 2232 2230
	2227 2235 2234 1790 2233 1756 2064 2066 2237 2163
	2164 2165 2055 2129 2128 2114 2089 2174 2170 2166
	2182 2186 2117 2185 2178 2191 2195 2169 2177 2173
	2171 2176 2175 2206 2209 2204 2210 2200 2202 2205
	2199 2196 2197 2183 2118 2172 2184 2188 1651 2162
	2215 2236 2067 3069 2068 3065 3066 3067 3068 2085
	3076 3080 3084 2044 3086 2083 2059 2073 3082 2084
	3078 2087 3081 3090 2046 2123 2070 2082 3088 3089
	3096 3103 3104 3097 3099 3105 2130 3098 3061 3107
	3106 3100 3087 3094 3092 3093 3073 3074 2079 3075
	3095 2080 3062 3101 3070 3072 2065 3113 2058 3116
	3112 3064 3110 3109 3108 3111 3114 3115 2072 702
	2181 3149 3118 3158 2168 3117 2187 2180 3156 3132
	3164 2167 3136 3153 3165 2179 3142 3145 3133 3147
	3154 3119 3141 3150 3157 2192 2190 3166 3268 3261
	3202 3205 3129 3130 3135 3207 3203 3204 3125 3175
	3266 3168 3267 3210 3213 3137 3155 3214 3211 3180
	3208 3184 3126 3216 3127 3167 3215 3182 3181 3212
	3223 3269 3222 3224 3151 3226 3219 3220 3221 3225
	3199 3218 3217 3183 3195 3131 3193 3139 3209 3206
	3170 3201 3124 3200 3198 3138 3230 3229 3228 3227
	3231 3270 3192 3134 3179 3178 3143 973 3194 3313
	3311 3314 3191 3190 3185 3169 3186 3189 3308 3307
	3306 3309 3302 3276 3315 3274 3275 3300 3305 3301
	3304 3310 3281 3279 3280 3278 3250 3249 3322 3258
	3255 3264 3260 3331 3377 3334 3263 3259 3257 3262
	3265 3252 3256 3251 3323 3320 3253 3254 3176 3177
	3128 3174 3120 3121 3122 3123 3159 3160 3161 3162
	3163 3232 3233 3234 3235 3236 3237 3238 3239 3240
	3241 3242 3243 3245 3246 3248 3282 3283 3284 3285
	3286 3287 3288 3289 3290 3291 3292 3293 3294 3295
	3296 3297 3298 3299 3316 3317 3318 3319 3324 3328
	3332 3333 3335 3336 3339 3340 3341 3342 3343 3344
	3345 3346 3347 3348 3351 3353 3354 3355 3356 3357
	3358 3362 3363 3364 3365 3367 3368 3370 3373 3374
	3378 3379 3380 3381 3382 3384 3385 3387 3388 3389
	3390 3391 3392 3394 3395 3396 3397 3398 3399 3401
	3403 3404 3405 3406 3407 3408 3409 3410 3413 3414
	3415 3416 3417 3418 3419 3420 3421 3422 3423 3425
	3427 3428 3429 3434 3435 3436 3437 3438 3439 3440
	3441 3442 3443 3444 3445 3446 3448 3450 3350 3411
	3432 3433 3447 3412 3383 3400 3393 3402 3494 3636
	3525 3620 3624 3622 3621 3585 3591 3595 3588 3526
	3471 3566 3552 3555 3551 3550 3549 3539 3536 3542
	3541 3546 3538 3537 3469 3543 3556 3557 3560 3561
	3562 3563 3523 3596 3574 3653 3584 3482 3558 3547
	3544 3470 3553 3474 3545 3573 3578 3569 3475 3568
	3572 3576 3567 3604 3602 3534 3587 3586 3480 3579
	3479 3590 3571 3577 3592 3593 3589 3478 3638 3632
	3613 3618 3614 3616 3651 3631 3606 3524 3633 3484
	3605 3609 3489 3612 3521 3611 3533 3599 3483 3532
	3597 3600 3486 3580 3603 3594 3634 3625 3629 3628
	3531 3627 3492 3640 3639 3644 3637 3648 3647 3641
	3635 3645 3481 3565 3652 3657 3660 3658 3656 3736
	3737 3735 3733 3739 3692 3691 3502 3693 3694 3701
	3795 3697 3507 3698 3699 3704 3505 3707 3709 3710
	3711 3726 3506 3724 3718 3714 3715 3717 3720 3741
	3719 3722 3721 3732 3723 3712 3700 3504 3740 3744
	3515 3742 3745 3743 3729 3730 3731 3747 3749 3748
	3516 3757 3520 3756 3751 3758 3517 3762 3760 3508
	3794 3764 3790 3772 3769 3782 3784 3690 3689 3777
	3512 3767 3513 3787 3753 3774 3510 3780 3676 3675
	3659 3662 3661 3496 3498 3678 3734 3679 3670 3672
	3663 3681 3680 3682 3671 3665 3499 3686 3687 3511
	3763 3688 3673 3779 3738 3376 3778 3643 3791 3500
	3491 3773 3674 3775 3575 3713 3786 3765 3856 3850
	3860 3865 3871 3879 3884 3846 3877 3875 3849 3861
	3855 3853 3872 3881 3863 3859 3862 3880 3926 3851
	3929 3919 3932 3934 3935 3912 3911 3909 3906 3895
	3907 3905 3914 3915 3913 3921 3916 3927 3848 3845
	3903 1223 3925 3924 3870 3892 3864 3882 3874 3359
	3896 3893 3327 3894 3889 3887 3900 3902 3890 3891
	3901 3904 3923 3920 3917 3852 3273 3372 3371 3325
	3352 3497 3750 3789 3946 3941 3944 3950 3949 3945
	3937 3936 3938 3947 3952 3954 3948 3727 3785 3940
	3951 3783 3781 3514 3957 1149 3955 3939 3535 3958
	3956 3966 3970 3843 3978 3972 3965 3964 3971 3962
	3963 3961 3960 3977 3975 3979 3976 3272 3369 3973
	3974 3844 3967 3969 3968 3980 3981 3959 3986 3987
	3988 3989 3885 3983 3982 4010 4024 4026 4068 3303
	3942 3943 3897 4113 4115 4119 4116 4117 4122 4200
	4198 4199 4163 4160 4162 4159 4167 4165 4150 4145
	4156 4157 4148 4146 4147 4144 4137 4158 4140 4142
	4131 4132 4166 4164 4168 4161 4133 4135 4124 4129
	4130 4139 4141 4134 3928 4121 4123 4126 4128 4127
	4138 4143 4149 4151 4155 4152 4153 4154 4120 4125
	4118 4112 4114 1139 1224 3451 3452 3453 3454 3455
	3456 3457 3458 3459 3461 3462 3463 3464 3465 3466
	3467 3797 3798 3800 3801 3802 3803 3804 3808 3809
	3810 3811 3812 3813 3814 3815 3816 3817 3819 3820
	3821 3822 3824 3825 3826 3827 3828 3829 3830 3831
	3832 3833 3834 3835 3836 3837 3838 3839 3840 3841
	3842 3847 3922 3930 3931 3933 3953 3984 3985 3990
	3991 3992 3993 3994 3995 3996 3997 3998 3999 4000
	4001 4002 4003 4004 4005 4006 4007 4008 4009 4011
	4012 4013 4014 4015 4016 4017 4018 4019 4020 4021
	4022 4023 4025 4027 4028 4029 4030 4031 4032 4033
	4034 4035 4036 4037 4038 4039 4040 4041 4042 4043
	4044 4045 4046 4047 4048 4049 4050 4051 4055 4056
	4057 4058 4059 4060 4061 4062 4063 4064 4065 4066
	4067 4069 4070 4071 4072 4073 4074 4096 4097 4098
	4099 4100 4101 4102 4103 4104 4105 4106 4107 4108
	4109 4169 4170 4171 4172 4173 4174 4175 4176 4177
	4180 4181 4182 4183 4184 4185 4186 4187 4188 4189
	4190 4191 4192 4193 4194 4195 4196 4197 2748 4075
	4076 4077 4078 4079 4080 4081 4082 4083 4084 4085
	4086 4087 4088 4089 4090 4091 4092 4093 4095 4207
	4206 4205 4233 4224 4201 4202 4203 4225 4204 4227
	4226 4209 4210 4211 4213 4214 4216 4215 4217 4229
	4228 4178 4179 4230 4218 4219 4221 4232 4231 4220
	4222 4223 4212 4208 4269 4273 4274 4272 4271 4276
	4275 4280 4279 4281 4277 4291 4289 4287 4290 4288
	4293 4292 4295 4300 4294 4296 4299 4302 4303 4305
	4306 4307 4304 4286 4301 4285 4284 4297 4298 4278
	4282 4283 4248 4249 4247 4245 4246 4257 4258 4259
	4235 4265 4264 4263 4261 4260 4262 4250 4251 4252
	4253 4254 4234 4255 4256 4267 4268 4270 4266 4243
	4244 4242 4241 4240 4239 4236 4237 4238 
}
sahila = {  #africa

	106 1005 1008 1004 107 1085 1140 1147 1148 1083
	1082 1080 1086 1141 1145 1084 1142 1143 1087 1081
	1079 1146 108 1121 1122 1076 1075 1074 974 1073
	1072 1077 1078 1091 1089 1090 1067 988 981 1003
	1065 1068 1061 1069 1055 983 1017 1049 1050 1011
	1063 1070 1064 1096 1059 979 1056 975 1092 1093
	1094 1095 976 1105 1111 1112 1115 1189 998 997
	1000 1001 1002 994 993 1015 996 1051 978 1042
	1012 1009 1062 1028 1099 1016 1098 1030 984 1027
	1041 1039 1046 1045 1048 1031 1036 1034 1032 1044
	1043 1040 1038 1052 1053 1100 977 1104 1101 1117
	1113 1119 1120 1118 1108 1106 1107 987 1037 986
	1127 1131 1129 1130 1128 1125 1123 1102 1124 1134
	1136 1132 1126 991 1150 1133 1137 1138 990 1332
	1325 1330 1331 1326 1324 1329 1024 1195 1196 985
	1054 989 2229 1109 1116 1110 2228 77 1718 2465
	1717 
}
oceania = { 
}
#S america
venatia = { 
	949 925 2311 2312 2313 2314 2316 2317 2318 2319
	2320 2321 2322 2325 2326 2327 2329 2330 2331 2332
	2334 2335 2336 2337 2338 2340 2341 2342 2343 2346
	2347 2348 2349 2350 2355 2357 2358 2359 2361 2362
	2365 2366 2367 2368 2370 2372 2373 2374 2375 2376
	2378 2379 2381 2382 2383 2384 2385 2386 2387 2388
	2390 2392 2393 2398 2400 2402 2461 2462 2463 2464
	2466 2469 2470 2661 2603 2662 2653 2654 2610 2663
	2656 2651 2647 2607 2608 2605 2606 2602 2669 2595
	2667 891 2668 2744 2741 2742 2683 2684 2679 2676
	2672 2677 2675 2673 2687 2688 2743 2686 2670 2623
	2631 2629 2630 2627 2632 2633 2746 2634 2635 2645
	2648 2636 2622 2646 2665 2652 2604 2609 2601 2596
	2394 2745 2737 2396 2660 2643 2617 2389 2611 2640
	2664 2399 2401 2616 2614 2613 2612 2621 2625 2626
	2637 2615 2619 2618 2649 2655 2674 2360 
}
#N america
chantlia = { 
	1210 1158 1160 1161 1163 1166 1170 1171 1172 1173
	1192 1193 1194 1204 1205 1208 1209 1211 1212 1213
	1214 1215 1216 1217 1411 1415 1416 1417 1418 1420
	1421 1422 1423 1425 1426 1428 1429 1430 1431 1432
	1433 1434 1435 1437 1438 1439 1440 1441 1442 1443
	1444 1445 1446 1447 1448 1450 1451 1452 1454 1455
	1456 1459 1460 1461 1465 1466 1468 1469 1470 1471
	1472 1473 1474 1475 1476 1477 1478 1483 1484 1488
	1489 1490 1491 1492 1493 1494 1495 1496 1502 1503
	1504 1506 1507 1508 1509 1510 1511 1512 1513 1515
	1516 1517 1518 1519 1520 1521 1523 1525 1527 1528
	1530 1531 1533 1534 1535 1537 1538 1539 1541 1542
	1543 1545 1547 1548 1549 1550 1553 1554 1555 1556
	1557 1559 1560 1562 1563 1564 1565 1567 1570 1582
	1583 1222 1313 1221 1207 1529 1219 1218 1497 1614
	1615 1845 1827 1486 1498 1500 1501 1586 1588 1589
	1590 1591 1592 1593 1595 1597 1598 1599 1601 1602
	1603 1604 1605 1606 1608 1610 1611 1613 1616 1617
	1618 1620 1621 1624 1626 1627 1628 1629 1631 1632
	1634 1636 1637 1638 1639 1640 1641 1642 1643 1644
	1645 1647 1648 1649 1650 1652 1653 1659 1664 1737
	1774 1776 1777 1778 1779 1780 1783 1784 1786 1788
	1847 1848 1850 1851 1852 1855 1857 1859 1863 1866
	1867 1868 1873 1874 1876 1877 1882 1884 1891 1782
	1646 1766 1767 1663 1661 1656 1770 1917 1914 1915
	1918 1916 1896 1912 1558 1546 1453 1449 1427 1480
	2243 2423 2415 2421 2410 1569 1571 2279 2277 2278
	2273 2241 2257 2238 2256 2344 2242 2255 2251 2253
	2252 2248 2249 1581 1584 1585 2280 2304 2310 2309
	2282 2281 2250 2345 1580 2244 2259 2245 2303 2300
	2291 2290 2289 2275 2286 2285 2271 2240 2266 2258
	2262 2269 2272 2247 2265 2268 2246 2305 2263 2261
	2267 2260 2298 2301 2294 2299 2307 1579 2306 2302
	2297 1167 1414 2491 2493 2492 2496 2498 2538 2537
	2542 2546 2528 2534 2505 2550 2531 1658 2526 1889
	2551 2533 2501 2532 2523 2504 2473 2471 1765 1888
	2472 2517 2506 2502 2544 2529 1771 2527 1768 2480
	2478 2479 1887 1886 2481 1772 2477 2483 2485 2476
	2510 2521 2511 2488 1412 1164 2508 1409 2482 2484
	2519 2507 2490 2518 2475 2495 2503 2514 1769 2474
	2513 2489 1410 2500 2276 2223 1846 2858 2548 2848
	2857 2849 2873 2900 2536 2541 2543 2872 2874 2898
	2897 2903 2540 2902 912 2535 2530 2875 2881 2905
	2904 2525 2878 2524 2879 2877 2871 2856 2855 2847
	2854 2845 2416 2796 2788 2760 2758 2449 2733 2861
	2887 2886 1862 1880 2889 2884 2885 2678 1861 2883
	2882 1865 1856 2906 1864 1858 1871 2817 2893 2892
	2888 2890 2868 2862 2891 2853 2863 2895 2761 2864
	2852 2860 2859 2899 2880 2896 2894 2846 2850 2844
	2539 2549 1574 1575 1576 1577 1578 2403 2405 2406
	2407 2408 2411 2412 2413 2414 2417 2418 2419 2420
	2422 2424 2425 2427 2428 2429 2430 2431 2432 2434
	2435 2437 2438 2439 2441 2442 2444 2445 2446 2447
	2448 2452 2454 2455 2456 2457 2458 2459 2460 2499
	2749 2750 2751 2752 2753 2754 2755 2756 2762 2764
	2765 2766 2767 2768 2769 2771 2772 2773 2774 2775
	2777 2778 2779 2780 2781 2782 2784 2786 2791 2798
	2800 2802 2803 2804 2805 2807 2808 2809 2812 2813
	2814 2815 2816 2821 2822 2823 2824 2826 2827 2828
	2829 2832 2835 2836 2837 2838 2839 2840 2843 2865
	2867 2876 2913 2914 2916 2917 2919 2921 2923 2924
	2925 2926 2928 2929 2930 2932 2933 2935 2936 2939
	2941 2942 2943 2944 2946 2947 2949 2950 2952 2953
	2954 2955 2957 2958 2959 2960 2961 2962 2963 2966
	2967 2969 2971 2972 2974 2975 2977 2978 2979 2980
	3060 952 1191 1654 1655 1660 1789 1791 1792 1793
	1794 1795 1796 1797 1802 1803 1804 1807 1808 1809
	1810 1811 1812 1813 1814 1817 1818 1820 1821 1822
	1823 1824 1826 1828 1829 1830 1831 1832 1833 1834
	1835 1836 1837 1838 1839 1840 1841 1842 1843 1844
	1890 1892 1893 1894 1895 1897 1898 1899 1900 1901
	1902 1903 1904 1905 1906 1907 1908 1909 1910 1911
	1913 1919 1920 1921 1922 1924 1925 1926 1927 1928
	1929 1930 1931 1933 1934 1935 1936 1937 1938 1939
	1940 1941 1943 1944 1945 1946 1947 1950 1951 1952
	1953 1954 2552 2554 2555 2559 2560 2561 2562 2563
	2566 2568 2569 2570 2571 2572 2573 2574 2576 2577
	2578 2579 2581 2582 2583 2584 2585 2586 2587 2588
	2589 2590 2591 2592 2593 2908 2909 2911 2984 2985
	2986 2987 2988 2989 2991 2995 2996 2997 2999 3000
	3004 3006 3007 3008 3010 3011 3012 3013 3014 3015
	3016 3017 3018 3019 3020 3021 3026 3027 3028 3029
	3030 3031 3034 3035 3036 3038 3040 3041 3042 3043
	3045 3046 3047 3048 3049 3050 3051 3052 3053 3054
	3055 3056 3057 3058 2993 3003 2973 3059 2907 2981
	2982 3001 3037 2956 2968 2970 2912 
}
island_check_provinces = { 
	2 30 
}
# Used for RNW
new_world = { 
}
