width = 5632
height = 2048

max_provinces = 4097
sea_starts = { 
	3 4 7 9 17 19 41 50 55 93 96 97 111 113 115 166 172 
	177 185 194 202 221 212 234 235 258 285 295 302 322 
	312 327 333 341 344 347 349 358 359 360 361 366 367
	399 412 415 416 426 427 483 487
	509 523 546 548 564 571
	579 588 598 599 600 604 624 629 640 659 660 662 664 704
	708 710 727 733 734 741 747 748 752 753 756 762 
	882 884 888 910 911
	795 797 817 821 824 828 829 836 843
	938 939 944 945 956
	1019 1013 1014 992 964 972 995 999 968 1007
	1088 1033 1035 1047
	401
	1144 1135
	1154 1203 1157 1155
	1242 1234 1249 1165 1169 1168 1220 1168 1206 1179
	1103 1058 1114 1156 1153 1159 1066 1060 1162
	1247
	980 902 1057 455 1227 1231
	1088
	1397 1327 1328 1343 1348 1388 1393 1396
	1397 1419 1413 1457 1436 1458 1424 1536 
	1462 1467 1479 1464 1485 1481 1482 1499 1524 1532 1522
	1514 1487 1463 1481 1505
	1544 1552 1551 1540 1566 1568 1561 1572 1573
	1587 1609 1594 1607 1600 1612 1619 1622 1731 1732 1029 1596
	1623 1633 1635 1630 1625 1657 1651 1097 1662
	982
	2035 970 1010
	1723 1743 1754 1747 1724 1742 1752 1707 1711 1719
	1764 1819 1816 1815 1763 1798 1787 1801 1875 1800
	1799 1775 1773 1785 1755
	2014 2017 1971 1987 1949 2038 2029 1883 2036 1942 1932 1923 1885 1878 1879 1881 1948 2081
	2198 2207 2042 2049 2063 2077 2071 2076 2198 2078 2194 2193 2156 2189 2153 2106 2096 2099
	2201 2203 2208
	2308 2315 2323 2328 2324 2333 2339 2351 2352 2353 2354 2363 2356 2380 2404 2395 2391 2397
	2426 2433 2409 2377 2371 2369 2364
	2545
	1006
	2600 2599 2598 2597 2594 2558 2553 2547 2580 2620 2556 2575 2557 2567 2565 2564
	2624 2628 2641 2642 2644 2650 2658 2657 2680 2681 2666 2639 2638 2659 2685 2682
	2720 2726 2704 2697 2702 2692 2703 2732 2738 2747 2740 2739 2731 2717 2707 2716
	2757 2759 2763
	2965 2964 2951 2948 2938 1872 2937 2945 2940 2931 2934 2927 2976 2983 2922 879
	2920 2915 2918 2901 2910 2870 2819 2790 2785 2789 2783 3009 2770 2776 3022
	2793 2794 2799 2811 2806 2834 2833 2797 2820 2842 2841 2825 2830 2831 2787 2810
	2818 2851 2801 2795 2869
	2440 2443 2451 2453 2468 2486 2497 2516 2520 2515 2494 2467 2512 2450
	2990 2992 2994 2998 3002 3023 1007 3005 3033 3039 3044 3063 3077 3032 3079 3071
	3083 3024 3025
}

only_used_for_random = {
}

lakes = {
	129 765 930
	977 
	1233
	1262 1263
	1306
	1313
	1825 1853 1854 1849
	1870 1869 1860
	2296
	2295 2293 2292 2288 2287 2284 2212 2213 2214 2222 2220 2223 2239 2254 2264 2274 2270 2283
	2436
}

force_coastal = {
}

definitions = "definition.csv"
provinces = "provinces.bmp"
positions = "positions.txt"
terrain = "terrain.bmp"
rivers = "rivers.bmp"
terrain_definition = "terrain.txt"
heightmap = "heightmap.bmp"
tree_definition = "trees.bmp"
continent = "continent.txt"
adjacencies = "adjacencies.csv"
climate = "climate.txt"
region = "region.txt"
superregion = "superregion.txt"
area = "area.txt"
provincegroup = "provincegroup.txt"
ambient_object = "ambient_object.txt"
seasons = "seasons.txt"
trade_winds = "trade_winds.txt"
#canal_definition = { #this sets the coordinates for where the panama_canal_river map file is inserted (starting from its bottom left corner)#
#	name = "panama_canal"
#	x = 1490
#	y = 948
#}
canal_definition = {
	name = "matliman_canal"
	x = 3131
	y = 1464
}

canal_definition = {
	name = "barzakhan_canal"
	x = 3468
	y = 1319
}
# Define which indices in trees.bmp palette which should count as trees for automatic terrain assignment
tree = { 3 4 7 10 }
