
#mytestgroup = {
#	1 2 3
#}

via_magreini = { #south-north
	705 703 716 711 717 519 551 561 560 643 642 495 644 540
	544 679 678 676 675 685
}
via_caroli = { #west-east
	496 655 532 567 533 637 543 633 642 494 572 557 558 493
	503 502
}
pamkusea_proper = {
	1237 1238 1239 1244 1245 1246 1243 1269 1266 1023 1248 1264 1251
	1229 1230 1225 1232 1235 1236 1228 1265
}
pamapoikia_province_group = {
	1290 1018 1226 1293 1294 1289 1284 1291 1283 1282 1286 1285 1281
	1280 1278 1279 1288 1287 1292 1296 1297 1020 1298 1295 442
}