
#mytestgroup = {
#	1 2 3
#}

via_magreini = { #south-north
	705 703 716 711 717 519 551 561 560 643 642 495 644 540
	544 679 678 676 675 685
}
via_caroli = { #west-east
	496 655 532 567 533 637 543 633 642 494 572 557 558 493
	503 502
}
northern_ostemer_ports_group = {
	719 726 781 696 346 402 407
}
zimahei_river = {
	3242 3245 3249 3250 3121 3251 3253 3256 3252 3257 3258 3259 3263 
	3262 3265 3268 3266 3162 3161 3159 3267 3168 3119 3339 3356 3354
	3254 3255 3122 3241 3260 3340 3163 3120
}